#domain
hospital
#levelname
MAPF02C
#colors
blue: 0,1,2
#initial
++++++++++
+0 1     +
+     ++++
+        +
+  2  ++ +
+3     + +
++++++++++
#goal
++++++++++
+2      3+
+     ++++
+        +
+     ++ +
+1     +0+
++++++++++
#end
