#domain
hospital
#levelname
MAPF02C
#colors
blue: 0,1,2,3
#initial
++++++++++
+0 1     +
+     ++++
+        +
+  2  ++ +
+3     + +
++++++++++
#goal
++++++++++
+        +
+     ++++
+        +
+     ++ +
+      +0+
++++++++++
#end
