#domain
hospital
#levelname
TwoAgentsDebug
#colors
blue: 0,1,2
#initial
++++++++
+    2 +
+      +
+ 0    +
+      +
+ 1    +
+      +
++++++++
#goal
++++++++
+      +
+      +
+      +
+      +
+    0 +
+  1   +
++++++++
#end